Aargau	Aargau
Abidjan	Abiĝano
Abkhazian	Abĥaza lingvo
Abraham	Abraham
Abraham	Abraham
Abraham	Abraham
Abu Dhabi	Abu-Dabio
Acropolis	Akropolis
Adam	Adamo
Adam's apple	tireoido
Aeschylus	Esĥilo
Afghanistan	Afganio, Afganistano, Afganujo
Africa	Afriko
Alaska	Alasko
Albania	Albanio, Albanujo
Algeria	Alĝerio
Algiers	Alĝero
Allah	Alaho
Alps	Alpoj
Alzheimer's disease	alchajmero
